1111111111111111
1E00000000000001
100000100C000001
1000001000000001
10C0001000000001
1000P00000C00001
1000000000000001
1111111111111111
