1111111111
1111P11C11
1111111111
11111E1111
1111111111
