1111111111
1000P00C01
1001000001
10000E0001
1111111110
